14 28
0 1
13 7
* **************************
* *      *                 *
* * **** * ******* * * *** *
* * *    * *       * * *   *
* * * **** * ******* * * ***
*   *    * *         * *   *
* ******** *********** *** *
* *           *            *
* * * ********* ********** *
* * * *         * *        *
*   * * ********* * *** ** *
* * * * *   *   * * * * *  *
* * * * * *   *   * *   *  *
******* ********************