8 7
1 0
7 3
*******
      *
* *** *
*  *  *
**  * *
** ** *
*   * *
*** ***